11111111111111111111
1EX000000000000CX001
1X100101001000001011
10100100101010100011
1P0000000C00C000X001
11111111111111111111