11111111111111111111111111111111111111111
11111111111111110000001111000000010000001
11111111111111100000001111000000100000001
11111111111111000000011111000001100000001
11111111111110000000111111000011100000001
11111111111100000001111111000111100000001
11111111111000000011111111001111100000001
11111111110000000111111111011111100000001
11111111100000001111111111111111100000001
11111111000000011111111111111111000000011
11111110000000111111111111111110000000111
11111100000001111111111111111100000001111
11111000000011111111111111111000000011111
11110000000111111111111111110000000111111
11100000001111111111111111100000001111111
11000000011111111111111111000000011111111
10000000000000000000000111000000011111111
10000000000000000000000111000000011111101
10000000000000000EP0X00111000000011111001
10000000000000000000000111000000011110001
100000000000000000000C0111000000011100001
11111111111111110000000111000000011000001
11111111111111110000000111000000010000001
11111111111111110000000111111111111111111
11111111111111110000000111111111111111111
11111111111111110000000111111111111111111
11111111111111110000000111111111111111111
11111111111111110000000111111111111111111
11111111111111111111111111111111111111111
